WWWWWWWXXX
WFIIIFWXXX
WFFFFFWXXX
WFFFFFWWWW
WFCFCFCFFW
WFFFFFFFHW
WWWWWWWWWW